너를 기억하다 - JulyLove Is Gone (Acoustic) - SLANDER / Dylan Matthew
銀色飛行船 - supercell
无名之辈 - 陈雪燃
Parties - Jake Miller
余味 - 林俊呈
海阔天空 - Beyond
Lemon - 米津玄師
想说 - 颜人中
Castle In Your Mind - Vicky宣宣
Head Above Water - Avril Lavigne
Look What You Made Me Do - Taylor Swift
孤单北半球 - 林依晨
当初的我们 - 大壮
银河与星斗 - yihuik苡慧
恋爱画板 - 锦零
This Love - Taylor Swift
You Are Not Alone - Michael Jackson
还是会想你 - 林达浪 / h3R3
We Are The World - Lionel Richie / Stevie Wonder / Paul Simon / Kenny Rogers / James Ingram / Tina Turner / Billy Joel / Michael Jackson / Diana Ross / Dionne Warwick / Willie Nelson / Al Jarreau / Bruce Springsteen / Kenny Loggins / Steve Perry / Daryl Hall / Huey Lewis / Cyndi Lauper / Kim Carnes / Bob Dylan / Ray Charles
Man In The Mirror - Michael Jackson
如果当时 - 许嵩
江南 - 林俊杰
你是落日弥漫的橘，天边透亮的星 - Hea2t
Love Story - Taylor Swift
Chaperone - Hurts
Fantasy - Jodie Comer
ただいま - 手嶌葵
No Eyes On Me - Justin Caruso
Darling - 朱彦安 / Anastasia
不想做朋友 - 李学仕
你，好不好？ - 周兴哲
不再联系 - 夏天Alex
过客 - 周思涵
孤单心事 - 颜人中
收敛 - 不够
潮红 - 杨默依Moi
Fiction - Adib Sin / Azuria Sky
灰色と青 - 米津玄師 / 菅田将暉
Superman - Keith Urban
洋葱 - 杨宗纬
No Place - Backstreet Boys
I Wish I Never Met You - Oh Wonder
Stuck with U - Ariana Grande / Justin Bieber
Daisy - R・O・N
Mood (Lil Ghost Remix) - 24kGoldn / iann dior / Lil Ghost小鬼
Crystal Ball - Lenka
Love You Like the Movies - Anthem Lights
You're Beautiful - James Blunt
Space - Famba
Is It Just Me? - Sasha Alex Sloan / Charlie Puth
Bikini Body - Dawin / R. City
Uncontainable - Set It Off
Nicknames - Walk off the Earth / gnash
Look At Me Now - Charlie Puth
More Than Friends - Mokita
Clean - Taylor Swift
质数的孤独 - 橙大蕾蕾
comethru - Jeremy Zucker / Bea Miller
Brave - Don Diablo / Jessie J
Soon You’ll Get Better - Taylor Swift / The Chicks
十年(Live) - 韩红 / 陈奕迅
Shotgun - Us The Duo
Boston - Alec Chambers
Good day - Lucky Stroke
Back to the Start - Jake Miller
Airwaves - Adib Sin / Azuria Sky / B. L. Hav
20 - 朱彦安 / Daria G
Sucker for You - Matt Terry
Mine (Illenium Remix) - ILLENIUM / Phoebe Ryan
孤勇者 - 陈奕迅
Like You Love Me - Conro / Disero / ALICE FRANCE
Leyla - Mesto
若把你 - Kirsty刘瑾睿
野孩子 - 杨千嬅
你不知道的事 - 王力宏
如一 - 不是花火呀 / 小田音乐社
某某 - 孟凡明
假装没变过 - 颜人中
Lying with You - Chase Wright
Daylight (Live From Paris) - Taylor Swift
Paperman - Christophe Beck
Savage Love - Metrixx
11 - 队长 / 黄礼格
予你 - 队长
All the Feels - Fly By Midnight
Back To December / Apologize / You're Not Sorry (Live) - Taylor Swift
错位时空 - 艾辰
summertime (Arrange ver.) - 麦吉_Maggie / 盖盖Nyan
当你走了 - 吾尊
Naughty Boy - La La La (bboy Mix) - DJ_Beat老果
勿忘我 - 要不要买菜
樱花树下 (Live) - 张敬轩
Honey (feat. Shion) - Kirara Magic / Shion
Saving Grace - Kodaline
Over The Edge - Kayzo / Gammer / AU8UST
Moody - Savannah Sgro
FLY-飞 - ANU
So Predictable - Set It Off
Letter - SHE'S
Break Up In a Small Town - Sam Hunt
Nobody Compares - One Direction
“人间の证明”のテーマ - ジョー山中
Closer - Boyce Avenue / Sarah Hyland
星星在唱歌 - 司南
My Love (Radio Edit) - Westlife
Bonfire - Peder Elias
If We Could Stay High (Edit) - Sj / Chelsea Lankes
Heart Like California - Before You Exit
Worth Fighting For (Otero Remix) - Otero / Rico & Miella / TELYKast
廻廻奇谭-OkadaTakuya (岡田拓也) - Vicky 黎偉棋
想去海边 - 夏日入侵企画
可惜啊 - 范倪Liu
说爱你 - 蔡依林
可 - 薛之谦 / 张靓颖
Retro Funky (Sundance Remix) - Persephone
挥着翅膀的女孩 - 容祖儿
A Night to Remember - Liberty X
I Blame The World - Sasha Alex Sloan
哪里都是你 - 队长
Mr. & Mrs. (I Do This For You) - Group 1 Crew
Locked Away - OutaMatic / Maddie Wilson / Madilyn Paige
The Day You Went Away - M2M
空山新雨后 - 音阙诗听 / 锦零
The Cure - Lady Gaga
给时间一点时间 - 曲甲
还是分开 - 王巨星
少年再见 - 何无空
My Heart Will Go On - Céline Dion
戒不掉 (原声版) - 欧阳耀莹
我的女孩 - 佤族黑男孩 / 王小草
Cry on My Shoulder - Deutschland sucht den Superstar
对玄机 - 任然 / 王梓钰
孤单北半球 - 欧得洋
Chance - Aspyer / Kyle Reynolds / Carly Jay
Where Did U Go - G.E.M.邓紫棋
U Make Me Wanna - Blue
夜航星 (Night Voyager) - 不才 / 三体宇宙
心似烟火 - 陈壹千
Bleeding Love - Ni/Co
Rather Be - Clean Bandit / Jess Glynne
一直很安静 - 王贰浪
Done for Me (feat. Kehlani) - Charlie Puth / Kehlani
House Party - Sam Hunt
Save Me - Listenbee
All Stars - Martin Solveig / ALMA
Rumors - Jake Miller
Can't Complain - Relient K
指纹 - 杜宣达
微微 - 傅如乔
我曾遇到一束光 - 叶斯淳
我走后 - 小咪
素颜 - 许嵩 / 何曼婷
美好事物 - 房东的猫
指纹 - 胡歌
那一刻心动 - 任子墨
落日亲吻银光海 - 皮卡丘多多
追寻你 - 王天戈 / 川青
就让这大雨全都落下 - 容祖儿
父辈爱情freestyle - WilB da water / SwordsAndWalk / Lonn.E
Best Is Yet To Come - Sandro Cavazza
山茶花读不懂白玫瑰 - Lil笑笑
字字句句 (Live版) - 张碧晨 / 王赫野
可能 - 程响
Way Back Home (Sam Feldt Edit) - SHAUN / Conor Maynard / Sam Feldt
insomnia - 16 / KURO
西安人的歌 (live) - 程渤智
其实都没有 - 烟(许佳豪)
小模样 - 张小只ya
I WANNA BE YOUR SLAVE - Måneskin
Exhale - Slotown
Everywhere We Go - 陈冠希 / MC仁 / 厨房仔 / 应采儿
小美满 - 周深
手牵手 - 王力宏 / 陶喆 / 蔡琴 / 江蕙 / 苏芮 / 庾澄庆 / 张惠妹 / 顺子 / 动力火车 / 张清芳 / 周华健 / 张信哲 / 伍思凯 / 张宇 / 周杰伦 / 李玟 / 吴宗宪 / 陶晶莹 / 林慧萍 / 蔡依林 / 许茹芸 / 萧亚轩 / 孙燕姿 / 徐若瑄 / 彭佳慧 / 信乐团 / 游鸿明 / 范逸臣 / 迪克牛仔 / 李心洁 / S.H.E / 周渝民 / 朱孝天 / Energy / 可米小子 / B.A.D / 黄立成&麻吉 / Tension / 林志炫 / 罗志祥 / 欧汉声 / 光良 / 品冠 / 万芳 / 温岚 / 黄立行 / 王心凌 / 杨丞琳 / 范玮琪 / 潘玮柏 / 丁文琪 / 林晓培 / 袁惟仁 / 张惠春 / 康康 / 黄韵玲 / 黄嘉千 / 许慧欣 / 路嘉欣 / 萧潇 / 江美琪
太美丽 - 陶喆
无缘 - 陶喆
寂寞的季节 - 陶喆
找自己 - 陶喆
流沙 (Reimagined) - 陶喆
今天你要嫁给我 - 蔡依林 / 陶喆
月亮代表谁的心 - 陶喆
爱我还是他 - 陶喆
Susan 说 - 陶喆
莫问归期 - 蒋雪儿
Done For Me (Syn Cole Remix) - Charlie Puth / Kehlani / Syn Cole
Heavy Is the Crown - Linkin Park
Blueming - IU
Arigato - Julie Bergan
租购 - 薛之谦
阳光彩虹小白马 - 大张伟
重返十七岁(新版) - 鹿晗 / 大张伟 / 薛之谦 / 魏晨 / 潘玮柏 / 刘敏涛 / 陈嘉桦 / Flyn张慧雯 / 张丹峰
